#####################
#...................#
#.#.#.#.#.#.#.#.#.#.#
#...................#
#.#.#.#.#.#.#.#.#.#.#
#...................#
#.#.#.#.#.#.#.#.#.#.#
#...................#
#.#.#.#.#.#.#.#.#.#.#
#...................#
#.#.#.#.#.#.#.#.#.#.#
#...................#
#.#.#.#.#.#.#.#.#.#.#
#...................#
#.#.#.#.#.#.#.#.#.#.#
#...................#
#.#.#.#.#.#.#.#.#.#.#
#...................#
#.#.#.#.#.#.#.#.#.#.#
#...................#
###################x#
