#########
#.......#
#.###.#.#
#.#.#.#.#
#.#.###.#
#.#.....#
#.#######
#.......#
#######@#
