#########
#00.....#
#0###.#.#
#.#.#.#.#
#.#.###.#
#.#.....#
#.#######
#.......#
#######@#
