#########
#..a.b.c#
#.###.#.#
#.#.#.#.#
#.#.###.#
#.#.....#
###.#####
#.......#
#####@###
