#########
#..a.b..#
#.###.#.#
#.#c#.#.#
#.#.###.#
#.#.....#
###.#####
#....d..#
#####@###
