#########
#.......#
#.###.#.#
#.#.#.#.#
#.#.###.#
#.#.....#
###.#####
#.......#
#####x###
