#####################
#00.................#
#0#####.#####.####..#
#.#.....#...#.#...#.#
#c#.###.#...#.#...#.#
#.#..g#.#...#.#...#.#
#d#####.#####.####..#
#........mMm........#
#.#####.#####.#####.#
#.bB..#.......#.....#
###b###########.#####
#.................#.#
#.#####.#######.###.#
#.....#.#.....#.....#
###.#.#.#.###.#.#####
#...#.#...#...#.....#
#.#########.#####.###
#.#...#t....#...#...#
#.#.#.#######.#.#####
#...#.........#.....#
###################@#
