#####################
#...................#
#.#####.#####.####..#
#.#.....#...#.#...#.#
#.#.###.#...#.#...#.#
#.#...#.#...#.#...#.#
#.#####.#####.####..#
#...................#
#.#####.#####.#####.#
#.....#.......#.....#
###.###########.#####
#.................#.#
#.#####.#######.###.#
#.....#.#.....#.....#
###.#.#.#.###.#.#####
#...#.#...#...#.....#
#.#########.#####.###
#.#...#.....#...#...#
#.#.#.#######.#.#####
#...#.........#.....#
###################@#
